10
#..#.#.##S
..##......
.....###.#
####......
......###.
###.#..#..
.G#.##.###
.....#....
####...##.
.....#..##
